##################################
#                           X  O #
#   P     #   X                  #
#         ##########    #        #
#   X   ###        #    #        #
#                  #    ####     #
#############      #    #O       #
# O #     O #  O   # O  #    X   #
#   #  X    ######## ####        #
#   #       #       O#    X      #
# X       X       ####           #
#                               O#
##################################
